type octile
height 22
width 34
map
..................................
.@@.@@.@@.@@.@@.@@.@@.@@.@@.@@.@@.
.@@.@@.@@.@@.@@.@@.@@.@@.@@.@@.@@.
..................................
.@@.@@.@@.@@.@@.@@.@@.@@.@@.@@.@@.
.@@.@@.@@.@@.@@.@@.@@.@@.@@.@@.@@.
..................................
.@@.@@.@@.@@.@@.@@.@@.@@.@@.@@.@@.
.@@.@@.@@.@@.@@.@@.@@.@@.@@.@@.@@.
..................................
.@@.@@.@@.@@.@@.@@.@@.@@.@@.@@.@@.
.@@.@@.@@.@@.@@.@@.@@.@@.@@.@@.@@.
..................................
.@@.@@.@@.@@.@@.@@.@@.@@.@@.@@.@@.
.@@.@@.@@.@@.@@.@@.@@.@@.@@.@@.@@.
..................................
.@@.@@.@@.@@.@@.@@.@@.@@.@@.@@.@@.
.@@.@@.@@.@@.@@.@@.@@.@@.@@.@@.@@.
..................................
.@@.@@.@@.@@.@@.@@.@@.@@.@@.@@.@@.
.@@.@@.@@.@@.@@.@@.@@.@@.@@.@@.@@.
..................................
